#########B##
########  ##
#### ### ###
####   #   #
A         ##
############